11111111111111111111111111111111111111111111111111
11111111110011111111111111111111111111111111111111
11111111102001111111111111111111111111111111111111
11111111122201111111111111111111111111111111111111
11111111222221111111111111111111111111111111111111
11111111222221111111111111111111111111111111100111
11111112222211111111111111111111111111111111000011
11111112222211111111111111111111111111111110000011
11111112222211111111111111110000011111111110000111
11111112222211111111111111100000001111111100001111
11111122222111111111111111000000001111111000001111
11111122222111111111111111000000001111111000000111
11111122222111111111111110000000000111110000000111
11111122222111111111111100000000000000000000000111
11111222221111111111111100000000000000000000001111
11111222221111111111111100000000000000000000001111
11111222221111111111111100000000000110000000000111
11111222221111111111111100000111001111000000000111
11112222211111111111111110001111111111100000001111
11100222111111111111111111111111111111100000111111
11000020111111111111111111111111111111000001111111
11000000011111111111111111111111111110000001111111
11000000001111111111111111111111111100000001111111
11000000000111111111111111111111111120000011111111
11000000000011111111111111111111112222000011111111
11000000000000111111111111111111122222200001111111
11100000000000011111111111112200222222000001111111
11111100000000011111110011222222222221110000111111
11111110000000111111100002222222222211111000000111
11111110000000111111100022222220021111111100000011
11111100000000011111110002222210111111111100000001
11111100000000011111110000221111111111111100000001
11111000000000011111110000111111111111111110000001
11100000000000111111110000011111111111111111120001
11000000000001111111100000001111111111111111222011
11000000000011111111100000001111111111111112222211
11000000000011111111100000001111111111111112222211
11000000000001111111000000001111111111111122222111
11000000000000000000000000000111111111111122222111
11100000000000000000000000000011111111111222221111
11111110000000000000000000000011111111111222221111
11111111000000000000000000000001111111112222211111
11111111100000000000000000000001111111110222111111
11111111110000000000000000000011111111110020111111
11111111111001110000000000000011111111110000011111
11111111111111111000000000000011111111110000001111
11111111111111111000000000000001111111111000001111
11111111111111111100000000000001111111111100011111
11111111111111111111111111111011111111111111111111
11111111111111111111111111111111111111111111111111
