11111111111111111111111111111111111111111111111111
11111111111111111111111111111111111100000111111111
11111111111111111111111111111111111000000011111111
11111111111110011111111111111111111000000011111111
11111111111100001111111111111111111000000111111111
11111111111100000000111111111111111000000111111111
11111111111110000000001111111111111000000111111111
11111111111110000000000011111111111100000011111111
11111111111111000000000001111111111100000011111111
11111111111111100000000000111111111000000011111111
11111111111111110000000000111111112000000011111111
11111001111111110000000000011111122200000111111111
11110000111111111000000000011111222220001111111111
11100000001111111100000000011112222201111111111111
11100000000111111100000000001122222111111111111111
11110000000111111100000000000222221111111111111111
11110000000011111000000000000022211111111111111111
11110000000000110000000000000002111111111111111111
11111000000000000000000000000000111111111111100111
11111110000000000000000000000000011111111111000011
11111111000000000000000000000000011111111110000011
11111111000000000000000000000000011111111110200011
11111110000000000000000000000000001111111112220011
11111100000000000000000000000000001111111122222111
11111100000000000000000000000000011111111122222111
11111100000000000000000000000000011111111122222111
11111100000000000000000000000000011111111112222211
11111100000000000000000000000000011111111112222211
11111100000000000000000000000000001111111111222111
11111110000111100000000011000000000111111111020011
11111111001111110000000111110000000111111110000011
11111111111111110000000111111000000111111100000011
11111111111111111000000011111002201111111100000111
11111111111111111200000011111122222111111000001111
11111111111111112220000001111222222211100000001111
11111111111111122222000001111122222220000000001111
11111111111111222221100001111112222222000000001111
11111111111112222211110011111111122220000000001111
11111111110022222111111111111111111200000000001111
11111111100002221111111111111111111100000000011111
11111111100000201111111111111111111100000000111111
11111111000000000111111111111111111100000000111111
11111100000000000111111111111111111100000000011111
11110000000000000011111111111111111100000000011111
11110000000000000001111111111111111100000000011111
11110000000000000000111111111111111100000000011111
11111000000000000000011111111111111100000000011111
11111100000000000000011111111111111110000000011111
11111111111100011000111111111111111111111100111111
11111111111111111111111111111111111111111111111111
