11111111111111111111111111111111111111111111111111
11111111111111111111111111111111111111111111111111
11111111111111111111111111111111111111111110011111
11111111111111111111111111111111111111111100001111
11111111111111111111111111100111111111111100001111
11111111111111111111111111000011111111111000000111
11111111111111111111111111020011111111111000000011
11111111111111111111111111222001111111111000000011
11111111111111111111111112222201111111111100000111
11111111111111111111111122222011111111111110000111
11111111111111111111111122222111111111111110000011
11111111110001111111110002221111111111111110000011
11111111100000000111100000211111111111111111200111
11111111000000000011000000001111111111111122220111
11111111000000000000000000000111111111112222222111
11111111100000000000000000000011111111122222221111
11111111100000000000000000000000000000222222211111
11111111100000000000000000000000000000022222111111
11111111100000000000000000000000000000002211111111
11111111100000000000000000000000000000001111111111
11111111100001110000000000000000000000001111111111
11111111110011111000000100000000000000001111100111
11111111111111111000000110000000000000001111000011
11111111111111111000000111000000000000000110000011
11111111111111111100000111000000000000000000000011
11111111111111111111001111000000000000000000000011
11111111111111111111111110000000000000000000000011
11111111111111111111111100000000000000000000000011
11111111111111111111111100000000000000000000000011
11111111111111111111111110000000000000000000000011
11111111111111111111111110000000000000000000000011
11111111111111111111111111000000000000000000000011
11111111111111111111111111000000111000000000000011
11111111111111111111111110000001111100000000000011
11111111111111111111112210000001111110000000000001
11111111111111111111222220000000111111110000000001
11111111111111111102222222000000011111111000000001
11111111111111111022222220000000000011111000000001
11111111111111111002222211000000000001111000000011
11111111111111111000221111100000000000111000000011
11111111111111110000001111110000000000011100000011
11111111111110000000000111111000000000011110000011
11111111111100000000000111111100000000011110000011
11110001111000000000000111111110000000011110000011
11100000000000000000001111111111000000001100000011
11100000000000000000001111111111000000000000000011
11100000000000000000001111111111100000000000000111
11100000111000000000001111111111111110000000011111
11110001111111111000011111111111111111000000111111
11111111111111111111111111111111111111111111111111
